               0              /
              0               /
             0                /
            0                 /
           0                  /
          0                   /
         0                    /
        0                     /
       0                      /
      0                       /
     0                        /
    0                         /
   0                p         /
  0                           /
 0                        0   /
                    0     0   /
                   00   Ff0   /
000   00  XYZ     00   NNN0 > /
000000000GGGGGGDDD000000000000/
000000000DDDDDDDDD000000000000/
///////////////////////////////