0              /
 0             /
  0            /
   0           /
    0          /
     0         /
      0        /
p      0       /
00DDDDDDDDD0000/
0000DDDDD000000/
////////////////